6,110
144,42
81,31
158,118
90,26
150,106
155,91
129,64
117,87
146,33
11111010111111011111110111011001001011111111111100111110111111111110101a011110011111111111111111111a111011111101101111111101011010001011100001111010101111111111
11011011111101111111100101111111100011111101111111111011110010111110011a101111111110110111111110111a111110111110110111010111101110111101111010111110110111110110
11000111111011110111101011111111111110000011111001111001111100111101011a100111111111110111111111101a100110111101111111111011011101111111101101101101110001111111
11011111110001111101111111111111111111111011110111111111010011111111111a111011011111111101111111110a111111110111111111101111111101101111111111111011000111110111
01111111110010100111010001001011111111111111111110111011011111000001111a111110111111110111111111110a101111010010011110011111111100011011011111110111111111011111
11101111111011111101111100111111100110101111001011111101111100101111111a110111111111111011110111111a001111110111111111111101100101011001111101111111111110111111
00111111111111111101101101100111111011111111110111001110111111111111110a111111111101101111101111111a110111101001110111111111101111111111111111011001110111011011
10011101011111010011111111111111011101111010111011111110111101111011111a110111111011111000011111110a111110011101011111111111101110101001111111111011101111010110
11111111010110111101011111110111101011011110111101010111101101111111100a010111111110111011111110110a111111101111011101111100110111111111111111101111111111111011
01110111111011111111111110111101011111000110011010110111001111101011111a011111110101110101111110110a011010111111111101011111111111111111011111110010011111111101
11111101111110111110111110111111110111111101111100111110111011101101011a011111111111011101111111010a110101111011111111111111000111111110111111011111111111111111
11111101111010010101001011011111110101000101111111101111111111110111001a010212212120120120121111121b221111111110110101100111101001111111110100101011010111011110
11011111011111111011011101111101101011011111010111110101100111111111111a111012021222000110211000121a112122101111010111111101111101011101001011011111111111101011
11101011010111110111011111111101001111011111011010111111111110111111101a111111012200221010122220001a112210211111111011010111011111101111011111111011111111011111
10110111111111001111111011001111111111111111111110111111111111110110111a111222010212121011021221122b202110211101101111011111011111011011110111101111111111101100
11101111111111111111111110111111101111111111001110110111111111011001111a111221101110102211221221110b022102211111111100010011111111111111110011011101001111101101
11111111111101101101011111111111111110111111101011011110111101111112122b102201010200202112202222211a102120101111011111111111111111111111110111011111001101111011
10101101111111111111101111000101111011110110111101110111111101000101211a221112210222221111122022211a122220011111011011101111011101111011111100111001111111111110
01111111011101111110111111011000111111111110111101101111111011111122011b122212221122212201222200221b102012211111110111111111111111111120011110110222012200121212
10111111111010111011111001110111111100110111111011111111111111110010222a010212022222202222220222222b001001111111101101111101011111100220202111121121120202212010
11101111111111110001011111111111110011111111101110110111111111011111021a111221222122122222001122222b101012211111011011101110111110021211120111201221111110012121
01111110111111111110111110110111110111111101111111111111111101011111112a021110100222012011221220222a222211010111111111101110011111110212101122221211110211122112
11111101111111110001001001110111111111111110111011110110111111111120110a122022211201221022212202021bbbaaabbaaaaaaaaaaaaaaa01111100111210111122211021211120112221
10101111101010111111101001111001111010101110111011111111111111011111111a1022000222212222222221022201022112200101111111111a11101010112201022212200210021120120201
10111100101111011111111110110010100111111010111111011111111111111112010b2120120222120112121221222220212102210111111111111a01011111121222111021120212100012222122
11110101101111111111101111111111110111011111011111101111111100111001022a0222122002212220202222222211202111100111000110001a11111011112122012202211baababaaaaabbab
11111111111111110111011011101011111101101111011011101111111110111012101b2020202021222202021222222200120210011110101011011a11111110121202222222201a21011112102120
10110011111101011111101111110111011110111111111111110101011100110111011b1122202220212222120222222210021201211110011110111a10101111011211201122221b10111100221211
10111110111011010111111111110111111111111111101111101010111011111101201b1222202221221222222112200211020121211011111111111a01110111122211210000222b11212111112120
11111111111111111111111011111111101111101111111011111101111110101112211a1012222222220222202222022212211222110111100111110a01011111122022111212222b11002010110212
11100001100111110110101111001100111101101111111101111111111100111001011b0112222221212222022222010022020101111111100111111a10110110111001122122221a10221211112200
10011101111111111111010101111111101011111111011101aaaaaaaaaaaaaaaabbbbaa1202222010222212102222222211112022111110011111111a11111101002222201111121b01212012210000
11101111111111001100111110111011111111011110101111a1111111010101110212212022001201202222200122222012000221210001011011111a01111111100201120221111b11200122201012
11111100101011111111001111101101011101001111011110a1100111011111001212111222211220220221122022020021220112111100011111111a00100011010211121211120b21001221100210
11011101010001110111101111110110101110111111111011a1111101111110111022101112120112222220122212220222220212011101111111010a00110111120212000222022b21210110021111
11111111111111111111011111111110110010111111100111a1101111101111110102212020022202220220212022002122212121110010011111110a01101111002120110221210b11221111222121
11110011010011011011111101110111000111111011011111a0110110111111111200021112002220202011121112212211011221111111100111111a11111111121112211101102a02121112211021
aaaaaaaaaaaaaaaaaaaaaaa110111011101111000101111010a0111111110111110122001111022222221200122220110101211222111010100111111a11111000120211220101121a12110121112211
1001101111011011111111a101111011110111111111010111a0100110010111112121012212202012010001212222202211110200111111111111011a11101111101012201020212a12211200220212
1111110001101011111111a111101111011101011111111110a1111111110111001101201122221212222222222202000200122211211111111001001a01101111111120111121120a20011000212022
1111111101110111110101a100110111011111101111110111a1111111111111111100022210222202222200102022020222212021200101111101111a10111010121001111010120b10001110200212
1110111011110111111110a111111100011111111111111011a0101011010111112011221212121200222222011212212022021120211110011111111a11111011112222121121111b21222121102122
1111011111111111011111a010110111111110111011001101a1111011011101112120102102202220221200211021120000111121101011111110111a11111011111110122210211a22212111020022
0111111111111111111111a110010111011111111011110111a1100010111111110200122212222102121022212120202211111111111111111101100a11101101121122200220220b20222220210211
1111111111101111111111a101011111111100101111110111a1111111100111112101022021112201021202120012222011111111111110111100111a11101110121012020120221a21122211112011
1011111111110111111111a111110011111101111011111111a1010101111010112200112212201221121211210022222111111100011101011101111a11111011102202221222110a12102112122121
1011111101101110111001a110111101111111111111001111a1001111111011011211101210121011121202200211121110101011111111001011011aaaaaaaaaabbbabaaabbaaaaa12121201101021
1111101111110111111111a001111110110111101101011111a1111000111011011222211211021212121012221210011111110111011111110111111111111101121222101201201122011111121102
1001111111111111111101a110110011111111111111011111a1110111111111101111101011111101111111100111111111011111111110111010111011111111122212111201221210221222110202
1101110111110111111110a101101101100010110111111111a1111111111101101100111110111111111111001011111111101110111101112112210200000110122220222122012211222121122011
1111010111111011111110a111111111101100111011111111a1100011110011000111001111011111111111011111010110111111111111111211112001010221020222201112102111111111011100
1111111101111111101111a111101110111011101100111110a1001011100101101111111111110011111110111111011111111111100001100122001210211020221111212011111111111111101010
aaaaaaaaaaaaaaaaaaaaaaa111011101111111111111110111a1000011111110011111011101111110010011111011011001111111111011010021012202210101120221202200222111011111111111
100111111010111100011aa111111001110111110011111111a0101101110101011101111110111111111111011111110100111111100011112122012112101122022211210120222001111011100111
111111111111100111111aa111111001111110001111111111a1111111111111111011011111110111111101111111011111110111111111111200001220202221122221122102222011111111011111
011111111110111110100aa110001011110000111110011011a1011001111111011111010111101111110101110111110111111111011110111121201221211111222111111120102110111110111111
111101111011110111111aa111111011011111010111101111a0110110101111101111111010100011111111011001011111110110111110012020220112202102202111202221022211100111011111
111011111111110011111aa110111111111111011110011111a1101111010110110111110111101111010011111111111111111111111111111201100000012222221002001112001011100100111110
111000101101111011110aa111111110110111101101111111a0111110101111011110011111011111100110111110111111111011111111112211121022200110222201111102201211111111111100
111001001111111110111aa101101111111111111110111101a1011111111111001001101001111111111110110110111110111010101111110210212020201201000012102220222211111101011111
110111101111111111110aa111111100111111110100111111a0111111110010011111011001111101111101010111000111010110111011112021011002112111012221111121001211111111111111
101111111111111111111aaaaaaaaaaaaaaaaaaaaaaaaaaaaaa1111101111000011101111001111111011111111011011000111111111110111111111101101122222110012222200101110111111111
111111110110111111111a101001111110100011100101111111111111111111010111101101110010111110111011111011111111111111011121111012002222021201112121221011111101101111
001110111111101111001a111110111101101011011111110011100111111101011111111111111011101011110111110011110111001111100022022110221122111012222012210211100110101111
111111111011011101111a011111110101111110011101111011011111111111111111111110011111111011101111101001111101111111010112201111202100112111122011200201111111111011
011111101011100101111a011111111110111011111111111110011010111101011001111010110110011011011111001101111111101001012111202102221011121011122102021111100111110111
011111111111010101111a111111111111111111111110110111111111111011011111101111111100011111111111101111110111011111102121101020200111011102021122100011111111111111
101010111111111111110a111011110111111101011011101111111111110111110101111111110010110111100111110111011110101011111112102100012011222211000111211111100011111111
010101011101011111111a111110111100010111010111111111011111111101111111110101111011010011111110111101101110111101112001111111201112121221221012211211101101110111
111100110100111110111a111111111011111111110011111101111111110101111111111111011111111111111011111110101111111111112122221111121222111120111022011210101101110110
111111011110111011111a111100011111111011010011011010011111111111111111111101110011111101111101111001111111111101102220211021002222212111211201022111111111101101
111010111111000111111a110111110011110100111011111111011101101000111111111101111111111011111011110010011110011111112212111211202202022022212110121211101111111110
011111111111011111100a101110000101111111110111010111111110111111111111011111000101111111111111011111110212002200101222220211212022012111112022212211001111111110
010111111110101011111a110111010100111111111111111110111011001101111111011111111101110110111010101110112022202100120001221121002211111222111211211011111101111101
111111101011110101111a111101110111001111101111111111001111101111111100100101111111111110111101111001112122212011102222112202222212220221212020212210101111001111
110111111001111101011aaaaaaaaaaaaaaaaaaaaaaaaa101111100011111111111111111011101111111111111011111111111111202222222002222211222122022211011121222201010101111111
111110111110111001111001111111101010111110111a111101111011011111111011101111101111111111101010111111111120121222002211211222212102220020020200222222112222110202
111111111110111010111011010110011010101001110a101111111111111101011111111111101111111011111111111111112200222010212222222201202022222002211022212221012122220221
011101111101111011111110111111111110111110111a011111101101101111110111111011111101001110101011011101111100020112222120200211220012210212102020222020222012210212
111010011111111111110111110101011111001111011a011101011011101111101101111100110111111111111111011110112212112222111222010212200212120221110022221100210011222111
111111111111111101111111111111111111111111001a111110111101111011110110111011111111111111111111001111101200111101222221221212002201221212011112211022102121221121
110101111111011111110111011101111000111111010a111111110110111111001111111101100011111011111111001110112022022121102112112011012201122201110121022111101222101121
001011111011011011010101111110111111010111111a011111111111011011111111101011111110110110101110011101111102202222201001221112222222012111001010200121111222221122
111111111011011111110110111110111101011111111a011111101101111111110011011101111111011111101101110111111011122121212222100122012020120211111111221021111121212002
110011011101011100010110110111110111111111111a011111011110111111111111001100100111111111011110111010011202000210220021101211112221112101111011212021221121221202
110101111111111111111110011101110111111100111a110111111111110011101001110111110111101111010111101110101111022012212120220022201112200010111112020222020121011221
111000100111110101111111101111001011111111111a001111011011111111101111011111111000111111101100111010110121122102010022102121210111212010101120201212112212111022
101111111011110111111111100010111111111111110a101111001111111111111001001101101111110111101011111011112011021011101121021221212210201210101112222101111202101202
1101111111aaaaaaaaaaaaaaaaaaaaaaa011110011011a111111111011111111111111111111011111111101111111011101110022112121110111001101211101111101111002101222110111121012
1011111100a101111101111101111101a011111011101a100011111100010111111110111111111111111111101111110100112102121112021120100112222100202210110021111212112112212022
1011010111a111111111111111110110a101100111010a110110111111110111011111111111111110100111111110001111101022201202012012221121110021110110010100101002121112202110
0111101011a101101101101111111101a011111111111a111111110111111111011111011110101111110111111011111111110000010021222111121122010210012212222222211222221222222222
1101111111a010111011111110110111a111110111111a111111010111101111111111101101111110111111110111111111112210010212010021102222202210210111021020222210211222201222
0111111111a111110111001011110111a101111111011a111101010110111111111110111110111110011101010101111111110211112210211220120211000011122011201112222220201222220022
1111111111a111110111110100111011a111011111010a011110110111011111111111111000111111110110111110111101110211021221012202202001112011112110221022221022202222022222
1111111111a111111111111111110110a111011110111a111110110110111100110101111001011001100101111011011111102121210201002221202101210120120012210022122221121221201222
0111111111a011111101011111011110a111110111111a101111100110111101111110101101110011111100001110111001101212121210102120011200202212121011002020022012110212122122
1011101111a100101111111110101111a111101111111a111011111111100111101101110011111111011111111111010101110101221212220121011222212020102101020222012102122001222221
1111101101a111011111011001111110a110110111011a111010110111111101111011111011111010111111111101111111101021112011222111221211110202202202222022222222221222002012
0111111011a111010100111011111111a111011011101a101101100111011111111111111101001100111110110011011111112221100212112111211212100210221202110200222012221222220001
1111111111a101100101100111011101a111011111111aaaaaaaaaaaaaaaaaaaaaa111111111100010011100111101110111012212020011222221000202222122012101120211221222022212201222
1111111110a011110111111110111111a111110111110111011111101111111111a111111111001010111110011111111111002100201222121111101012000122112110220102222220102201222112
1111111111a111110001011011111111a111110111100111111110111100110111a111011110111110110000111111111110102102121121112022221000121122011101212220212112222202121120
0111110011a111101111110011111100a110101111111110101011110011111110a111111111111100011011111111011111111202221222022020111221110212122010110122112221022122212122
1011111111a011111111011110111101a010111111100101111111111111011111a111101111111011111011101111111111111111001111111111111111110111111111202121120022002210122220
1011101110a111111110111111111011a101111110111111010101101011111111a011111011111110111111010011101011100110111111111101011010111111111102002200222222200220022222
1111011011a111111110010111101111a111101111111101110011001111111111a010100111000110111111010011111011111011110110110111111111111111101111101102212222222222222221
0011100110a111110111000111110111a111111111101101111101111110111101a111001111111011111111111110111101110101011100101111110011110010111102111002222000021220120022
1101111101a111111101110111110101a111101110111111111110111101000011a101111110110011111010010110001111111110111111101110110010111101001102111121122122222120212122
0011111111a011110111101101110111aaaaaaaaaaaaaaaaaaaaaaaaa101011110a111111111110111110110111110010101111101111011010111111101011111100102021110221222021022210112
0111011011a011111111101111101110111111111111010011111110a110111011a110111111111011111111111001011111110100111110011110100101111110010100221112000212122221121220
1111111101a111111000111111110011111010111011111111110111a111110111a011110111011111111110110011111111101111111111111111111111111110111012122021110122212121112020
1110011110a111111101111111101111111010111011111101111100a111011011a010110111111111111111011111111111111111111111111110101110111111110111122121111021221122101212
1110111101a110010111100111111111001101101111111111110111a101010110a100111111111110011111101111110101011111111111010111011111111111110112121212100122222222212221
1011111111a011101101111111000101111111011111111111010100a110001111a111110111011111101111110111101110111000110011111111101110110111111102220022120102220222002212
1110111111a110111101111111101111111111100111011111111111a111100111a111101101111111001111110111111100110111111111110111111101111101110110120212110222220221022002
1111111111a111111011111000111111111110111011111111101011a011111001a110111111110111100101111011110111111011010001110111111111111101111112112120002221022222222222
1110001101a110111111111010111110111011011101111111111010a110111111a110111110001001010000011111111101111011110101101111111111111110101111211122122011122110012022
0111101011a111111110101111010111111101111111110111111111a110010101a110111110111111111110111111111111111110111111111110101101101011011000202121112222220220202221
1110110111a111111110111111110111111111011101101111111110a011010111a111111100111011111111101110101111111011100011101111111111101100111110221212022222210222022000
155,73
15,34
65,3
39,119
13,31
146,99
122,9
31,106
153,52
4,35
76,116
122,15
0,58
150,107
0,59
145,28
140,46
5,89
