8,108
140,2
149,28
114,68
95,57
134,52
125,108
93,58
99,40
33,92
11110111110110111011010111111aa111111011101a11111111011111111001111110111110111110111001111111111101a11111011111111011101111111111111101010101111111111110111011
11111111111011101111100100110aa111110111111a11110111111111110111111110110111101111101110111111111110a11111111111110110011111111100111011001111111111111111011111
10110101110110011110110101010aa111111110011a11011001010111111111011111101010011111011110011111111111a10111111111111110111111100111111110110111111011111011011100
11101101111111111111110111111aa111111111100a10100100101101011110111111111110011111011111011000110111a11111100111101111101011010111111001111100101111111010101111
11110100100101011111101101011aa011101111101a11111110111111111111011111111010011101011111101101110111a00111110111111110111101111011111111110101011111101111100001
10111011101111111111110010111aa111110101111a01111111011111001111111011000011101110111010011110111110a11011111111111011001011100111111110111110111100111111110101
11111110011111001111111011101aa011111110110a11110111111111111111111111111111101111111110110101110111a00101101111111001111101101010101101001101111110101111111111
11110111111111100011111111111aa111111011011a11111101101110001111111111111110111111110111011111111011a11001111111011111011100111111111111111111111101111111111110
01110111111111001111111011101aa101110111111a11011111111111110101111111011111011111111101101111011110a11101110111111111101111111011111111111111111111111111110111
11111110111111111101101111101aa111111110111a11110111011011111111011101111101111110111000111110111100a10101110001110110101101111011011111101111001011111110111111
11110110110111111111111111100aa011100011111a11111111111111111001111011111110111101111111101111110110a11111111101011111011101111110111101111111111011111011111111
11111111101101111011111101111aa101011111111a10110011101110011111010111111110111001111011110101101111a01111111111011111111111111010111101111100111011011110011011
01111100011011101111111101001aa110111110011a11111111111101101110111011101110111011111110111111011111a10111111111111111111110011100101110111110111111100111111101
11111110011101110001111011101aa011111011110a11110111011000101000110111111011001111011111100111111011a11010101110101111110111111111111122222111121111202101221112
10011110111110110111110111011aa110111111110a00011100111101010111111011111110010110011110011101111111a00010111111101111011111111111110111102220202102111111122121
11111111111110010111100011111aa111111111111a11111011010111111101111111111111111111101010000111110111a11111111101111011101001111111111012121220122111111100111201
11111111011111111111111111101aa111111111111a10111101111111011101100011111101010101110110010001011110a11101101110100011111100101111111111222110022211120022102112
11111100111111101111110110111aa111110001111a01111111100111101110110111111001110011110111111111111111a10111101101110111110111010111111121100222210220111211101102
00110111111111011110110101111aa101111111110a11100111101111111111111111100101111111001101111110111101a11101110110101111111111111111111120001012022122212120012211
11110111111111101110110011001aa010101111111a10111110111110111011110101111011111111111001111111111110a10111111110111110111110101101111122111221021211020102100221
01010101110101111111101111011aa111111011110a11111111111111110111111110110101100111110001111111111110a01101111011111110001010111111101121011112102222002120212121
11111101111111111111111111101aa111110111011a10110111111101110010111111111111111111101011101011111110a10101111101110110100101111110111111211211101121012200112221
01011111011001101011111110111aa111011111111a01111011111011110111101111111111111110110101111111111001aaaaaaaaaaaaaaaaaaaaaaaa110111111021121122211102020212122210
11101111110001111111011101110aa101111000011a1101011111101011111111111111001111111101111111111111111111011101110110111101110a010110110101211021122211110121121110
11100110011111100111011111111aa111111111111a1111111011111001111111111111001011111101111111111111011111011101001111111111111a001101011122221222011122110211222111
11111111111110111010100111110aa011101011101a0111111011111111111111111111111100001111112210020211211222112012202202120101111a111111101121021112022122011021220010
11101111101001111110101110110aa101111011111a1111011111100011111111110111111101111011222222112222012212111112112012021110011a111111010122211122112220212220211201
11101111111011111110111110111aa010111110001a1101101111011111111101111111111111100111010120221220021012101111112200111111101a111111111111110100200122221112120020
11110111111111111111101111101aa111111110011a0101110011110111111111001111111111001111212201122111210122112102212221021011101a011111001111011212212022211211122010
00010011111111111111010111111aa111111010111a1111001111011111111111110011111011111001021121212121011200221121111011211111100a101011101111202120120112110112002101
00101100111110101111011100111aa111101110100a0001011111111111111101111101111001111110202212112122122121210012102101121111101a111110010122211110120122211122220221
11101011111111111011100111111aa100110111111a1110001111110001110111101110111100111111220112011011221221121012200212110111101a111111111110101121112221120102100011
11011100101011110110001111111aa101110110111a1111110011011111110111011111001111011110122200211222122212202112222122121011111a111111111002021012201222122111121220
11111111110111110010110111011aa111101110111a1101110111111111110011111111001011111010101121202210210111022222112122120101111a101101111021221010202120211211222101
10011111101010111111001110011aa111111101111a1111111100111101110110111111101111101111110112221211221122012102012112211110111a111011111121211202122112011212221120
11111111111111111111100011110aa011101111100a1111101101111111100111110111111011111101110221101220221210221222221111111111111a011011111111212112021222211200202210
11111111110001111010111101111aa101011101001a1111111100111111111110100111101111110101102101120201110122002020121120221111101a110111110102112222201200121201012201
11001111111011111011111010101aa000110111111a1111011111110011101111111111111111111110002211221211211122121222222112110012210a120202021112222220212220212222122112
00100111011110110110110101011aa111101111111a0101111111111111111011110011111001111101022120111012122211122211201112111010122b222202221101022212220120021112021210
11110111111001110011110111111aa001011100110a1000101111111110101111110011110111111110111222201101120122111211020212020111120b202112012220202222101212212222121011
01010111111101111111111100111aa111110111101a1011111111110111111011111011101111100011112120102112122121200222221212001111110a222012102112222211022221211102220112
11110101011110111101111111111aa110111110101a1011001111011001111101111011111111111110221020122120221002202122012212111010112b202212010122121002020212212122112021
10111101101111111101111111110aa111101111011a0111111110111101111111110011101010110110022220212022021222012002221221121002021b012101011121101201222222102112221101
01111111100011101011111110111aa111011011110a0011011101011100111111100111110110102211222200220212221220222220122221121112222aaabbabaaaabbbbbbbbaabbbb222022112012
11111111001111101101111101111aa000111011010a0111111001111010111101111111110111222222222220220222221012011022221021121110222221211110022200222120102b001112211011
11111111101010110110011111111aa101110111110a1111110101111110110111111111101111112222222220222222220122220222212011011011212222221111210002221201221b210101110111
11111111110111111111110010010aa111101111111a1110111110101011111101011111111001110201221222212222020222220022222022221112202111102211122210111210101b221011111011
11010111001111111110101101101aa111011110111a1111111011111111110100111111111111222021202222222012020020202220220122211111211002021202212122122212212b120111011111
01101111000110101111110111110aa011111100110a1101110111101001110011001111110111100220202120200210222222222000220212121011222212212211112211110122021b221101111100
11011111111111011101111110101aa011111111111a1110111111111111111111100010011111122212202222020222222222221102210201110112122221111022012012221111111b111111111101
11100011101110111110101100110aa101111100111a1101100011011110111110111110111101112120222200202222220102220222222012121012121122121001200101122021102b121011111111
10111111011011110010111111111aa111101101000a1111011111101110110111100101011111220202221022221202222222200222122211111112121202220121022222202212220b110111011011
01110011101111111110101111111aa111011111110a1001100111111111011101100100111001222222222122222222012012120202202222120111100210211002021112220202110b111111001001
11001011011101011111010111010aa111101111111a1101111011111011111111100111111111220112222211002210022222020022202122120112020120212022202120211020111b012110101111
11111111110111111111111101001aa101011110111a1111111010011111100110111111111001111222200222212212012022022220020122102211221122001210222212111221212a012011111001
11111111111111100111111011101aa011111111101a0011111111110010111110111111000100201122020210202000012220222222022212212202112222221021101100102111222a112011111110
11100111101011000111111111101aa111111111111a1011111111100111011011111111111111222220220022002221122222002202222120222221021002222221022011122102201a002010111010
11011011011101111111011011110aa011011111111a1111010011111111011011101110111111012222001221202222022022202001121012122021221021202200211201111021210b111111100111
11111111101111001111111011011aa011111011100a1011101111101011110111111101111011222122220122222202222022021221222122202002222221200221011121221221001a221111111001
11111111111111111111111111001aa110000011111a0111011100111111011110101101111111002102122002112222022220220210022212021112211122222221211201102121010a211101110111
01011110111111011110111111111aa111111111111a1111010101110011110111101111111111212022210200222020202002222222202222111111212222222112102212120112102a221000111111
11000100011000111011111110000aa110011101011a1110111111111110111110001111111111102222220202202121122222221020020202222120222022202002022201112102010a112111111111
11011010101111111001111011111aa110111111010a0110100111111111111011011011101011211220211222112200220222022200211212222120021222222202111122210122210b221111111111
00001110111010001010111111011aa101110001111a1110111111111111110111111111111001222200012220021112121220222002222212211222102222221210211122111211121a110110111110
11011111111100111111101011011aa111011111110a1101101011111111001111111111101011112221120220220021022222212222220201211020220022101220110220101120211b111101111111
00011111111111001011101111111aa101111111000a1100101111111111111111110111111110220122201212202202222200002222221211212200102022210201101022021212000b201111111000
11100010101110011111011010110aa111001101111a1111100010011010011111111111111110202012220220101202000222222212222012120211100200000122011201120100212abaaaaaaaaaaa
11111111111111101111101111010aa110011111111a11111111111111111111011111111011111212122220202222221202222220212022021221022222221200011112122221121002122110100111
11111100100110110110010111011aa110111111111a11011011111111011111111111100111101021221202121221122022222212121222111021122202221220211122011120211122122111111111
11110110111011101111001110111aa110110111111a11111111110111101111001101011011112011212202222122120221120222220121121121100012112002200111010110110101111101111011
10111100101010110001110101111aa111111010101a01110111011111111111111101101111112222202000002222111220222221022222122112222110221212200111111100100111111111111110
11111111011111110101100111111aa111111110111a11111101111111110110011100101111111201102211102211120222000222222220120111212212221011111101011001110111111111111001
00110011111111111111111111111aa111111100101a11110111111111011111111111101011101222022220220222022122222201200222210002120221211011201011101111111111100111101111
aaaaaaaaaaaaaaaaaaaaaaaaaaaaaaa100111111011a00011111101101111111011111111101112012222220020221122122220122022222110101111202120200011111111011110101111111011111
110111110111111101111111110111a101101011001a01111111011110100111110110101111111202211122201122101122012212112010211121220212222222010101101110111110111111100011
000111101111111111110111100110a111110111111a10110110011111111111111101101110011111011111001111110112122001022010121202221202211101210101111111111111110110110111
111111111101111111111111111010a110111111111a01111111111011111111101110011101110111111101111110101100022111111020212012210101000121210101111101111101111111101001
101111101111111101122002120100b212111200102b20210211011111111111110111111110111010110100111111011112221221201112221122120002101202211111111011111110111111111111
111110111111011111122111220111a110201220222b11210111111110111111111111011111111111111111111111111112020102211222112220102101211102011100011011011111111101101111
000001111011111111221111211111b122211122221b11212011111111111010111101101111110111101011111111111101222021212012122212111101011111211011111100011011001101111110
111011010110111001212110022101a020222201122a12212211111000101101111100110100010110111111111111101112021212221110122112102012112221211110011111110111110111001111
011011000111111101102222021102b120112002121a22212000111101111101111111100110111010011111111001111110011100011211020222212000110211111111110101101111011010010111
111101111001111110110220200111b012111020222b22122111111100011101110100111010101101011101111110011102101222121210211022112212100102111110101001111111110110111111
aaaaaaaaaaaaaaaaaaabbabbaabaaab111111112101a20211201101011011111101111011100101010011011111010010111011000222110122222212021220001111101101011111111111011110110
1011111110101111110122abaabababbabaaabbbabaa02010111111101001111110111011011000101111111101011111112221011120211111112112021122120210111101101001010111100111110
1111111110100011112111b02222120221111102210211012210101110111011111001111111111111001111111111110111110010111101111101111011111100111110111101100101101111101111
0011111110001110001112b02222220011101121002110121110111010111111100111011111111110101101111111111111111100110001011101011011111101111111101011101111111011001110
1111000111100011111011b21112101201222221010211210101111011111111110110010010111111110111111111110111011101111100011111110001001110110011011110100011011010111111
0111111100101111111111b20012211120112221210221212001111110111111101110111111011100101111010011111111010111101111111101111010111111111111111111111101111111111011
1001110011111101112200b01112222222022201212222221111111111111011111111100111101101111111101011111111111110110001010110111100010101111110111111011111111111110101
1110110111111111111012b22221102201220200101112011000111110101111111111111111111001111101110111111010101111101011100101111011001111011111111111111111110101111110
0111111111111011111211b21222002210102111211212112210101110111111111101111111111110111111111111110111111111111110001111101010111011101101111101111011011101111111
0001111111111111011221b02202121101222112210112212211111110110011111111111111110101111011011010011101111111111100100111111011111111111111111111110110111101101111
1010010111111011101112a01112222111111221102200212011111010111010111111101101110101111111011111110111010111001112212222222011121221221211222221111111011111101110
1111100110101111102121a02221102121121122112202122111111101100111111011110111111011101111001010110111111010011122222212212221101112121111011101101011111111111111
1111101111001111001111b10022220220220222212010102111011111111010111111101111111111111011111101111011101110111101121112220101012212121122102202111111011110110100
1111001111011110011202b21200020202010211222022222110010001011111111111111011101101011111110111111110111111111021212212212100022012110212222202101111011111111101
1001011001010111110121b10101000010222102121111120201101111111111111001111111110111111111010111111111101111111122122211212102010212021211121201111011111011000110
1011101111111110112021a11111122102102122111021121010111111110010111111101111111111110101110111111101111110111101112111221121212010112111111222101101111101101111
1111111000111111112210b11112112122100221212111120111101111101101101111111101101101110111101111010101100111111021220120220121212111101022112111111111010101111111
1011110011100110101121a11020220122011112121001111100110111111111011111100011011111110011111111111111111001101111211201011121222212121210200210101001001011101111
1100111111111111112011b21011211110021222002211111101010110111011111100111111111111011100110111111101110110111101121220202222102101202102111221110110001111001111
1111111100111111111212a02102002212210101111221210201110010110110111111110011111110111111111111110111011111111121201021122111101212211210221012111111011011111011
1100011010101001102101b01102012012121110002011012211111100010111110101100111110101110010111111110111101110111111211222012111201202121222111112111011111110101110
1111011110111111112101a21201211222121001122221121101111110111111111100111111111100111101111111111111110110101122120110212211011112210220210222011101101111011111
0111101111111111112210a12222101210112002212012120011111111111011110110111001111001111111110011111111111011111122211211220002011211201202022211111111111111110011
aaaaaaaaaaaaaaaaaaababb12002212201121211002201102211110111011111010101111110110011101111111011101110111010111122121101202111102202120221011101111110100110111111
1101111111111111110112222212222201211121100110000211111111110101011011111011101111111111111011111111111111111021202221121212220210202012222111101111111110111111
1111101111101111110002211112021122022101210110021211111111011111101111001011101110101111111010111111011111111102020121211212101200222012102220110111010111101110
1101111111101100011011101110011111100111111101010101101111111101110111110110011110111011111111111111111111111102011111221012210101012012211110111011101111110111
1111010111101111101111110101111111001111111011111110111111110110111111010101111111111111111111011110111111111122011222221111121012221222200122011111111011010011
1111101010111110111111111010011111111110111110101110101001101110101011101111111100111111010011101111001111111120112222022222100221220212220121111111111111111111
0100111111000001110111110111010101011111010111111101111111111110111011111011111111111100011111010111111111111002021212221111110212011001211221111111111111111111
1001111110111110111111111111101101111111101111111101111111111111011101001111111101110111111110111011101001011122022212120212120111022221012121111111110111111110
1011011111011111111111111111111111111111101111110110011110110111011001111101110111111111110111110111110001111121222222121101211220022011222212111010111111011111
1011110110111111101111111111111110110011001110110101111010111111111111101111101111111010011110111111111111111122111211212001201110221222101110111100111110111011
1111011101101111101111111111111111110001111110111110111110111011000010010110001111111111111011111101111111101120221021212221222222120012221002110110111001010111
1011011111111110110111011111101111111111101101111110110001111011001011010101111111110111111111111111111111111122011010101110121211221112021102111111110001101110
1111100111110011101111111111010111101110111011111010110111111111111100111110111101111110111110111101010111110120221001012111122201121111120121111001111001111111
1011011111111110111111111111101111111110111001110100101111111111101111111111111111111110110111110111111100111101012020221102222012220200112221111111111100111101
74,111
49,10
156,53
8,110
13,90
151,78
153,50
14,27
84,2
35,101
156,113
140,1
106,11
32,119
141,9
102,111
12,66
140,50
