14,53
144,66
51,16
16,82
137,10
67,40
96,62
134,14
94,78
144,72
111111011111101101011111111111101101111111111100111110111011101111101111101111111011101a11101111101000011110110011010102202202212b222222102222222201110222011011
111001111111110111111111111110000011022012220021102112111200211110111111100111111111111a10011111111111111100111111111111212120222b022201201200211212121010011111
110011111101111101110aaaaaaaaaaaaaaababbbaab0210101102122112212012121110101111110101111a11101111111111111111101010101112210112222b222222212212202222120111001011
111111010111111110101a111111001111111102212b0202212121121202111101110011111111111111111a11111011111111111111111111111111220021221b221211210202220020221112011111
111111100111111111111a111111110010111220201a2210022122210021210211121101110111101110111a11110110111111101111111111100111112202102a010122201212120220021212101101
110011100111111011011a111011111110111112212a0121210021212122101101210111111110111011111a11111111010111001111111011111111212222222a22222002020020200222bbaaaaaaaa
111110111101111101111a010010110001112020002b1021212110212111211222221111111101010111011a11011110111011111111110101111101012212222b02202220002212112122b102111101
001110111101011110111a110101111101110111221a2221120020221100212221100011111111111110011a11111101101110110111011111101111102121122b20221102220022222121b012101111
001111111111011110101a111111111111011221101b1201222122211212102112101111111111111101110a11111111111011110111100101101112111020022b01220010220122101201b020101110
110111111111111111011a011111111111001021200a2202120100020221011221111101011110111101111a11110111110101101011110011011110112002122b22202022222022210211a111111100
011110111101111011011a111110111100111222111b2121222101211122222211221011111110111111111a10110101011111111101100111001112200102211b22002000022222221222b222111111
111111101111110011111a111110111111101211012a0102221102002110022112221111011111101001100a01111101111110101111111011100100010202012b21122220202122211212b010101011
110111111111111010101a011101111101112022211a1222002121100220010022200010101110100111011a11011110111011111110110111110012211212222b02212212120222002222b211111111
101111101111110111111a101111111111101111111a0112200100222112220121001101111110111111111a10111111111111111011111111111112212221210a22200111012112121220b211011110
000110000100101111111a111001111111112110221b2120122212111111021112201111111110101011101a01111100011010010011111111101012012222101a02122222221222222202b122011111
101111111011111111111a001111111101011012111a1212212012220200012120210111111110111110111a11111001111111111111111001101112122222022a00120222222021212222b101111110
111111101111101011111a111100011101000111211a2112122120220012212111221101111011101001011a11111101110100111111101011111112212221202a22122222201122212222b111101011
011111111111111001111a111111011111102101112a1110221212121212100212110110111111111111110a00011101101111011101011011011011010222220b22222212222020210021b112101111
010001111111000101111a111011110101100012201a1222120120121111020112001101111101010111111a11110011011111111111111110001112220122001b22221222220211111020b210110111
100110011011111111011a101111010110111201012b0000220211220210120110111101111111011001111a10101111100111111111111111111112211122022b20202222210200200222a121111001
010011101111111111111a111111101101112102020b0212221222101021212101211111111101001111111a11011110110001100111111101111002102211022b22202212210101221222a120011110
100011111110101101111a011111111111112212112a2122121112121100221100020111111111111010011a11101111011111101111111001111012222221212a10222120112202212210b120111001
101011111111111111111a101111011111012012020a0121112012101222110020210111101111110101011a11011001111101101110111111011111102222210b20022102122120200012a112111111
aaaaaaaaaaaaaaaaaaaaaa111111111011112211121a2101120101021222221012121111101111110111110a11110111101011111111111011011102201222122b21121211211002222222b221111111
1001111011000111111111011111110111111001102abaabaaabbabbaabaababb0121111011011011111111a11011101111111111010101111111101010222002b02022212221001122110a110111111
1101110111111111111111001011110110112112221220110111202220022221b1011122111211212221011aaaaaaaaaaaaaaaaaaaaaa10111111110220122211a02022212121222111222b202001111
1100111111111110111111110101111110011212122201210110222111011202b2221012202112000221111000011001101100101011a10111101110222210220b22220221210221202110b102110111
1111011110111111111111111101111001112001111120222121102112220222b0121011211221220122010111111110101111111111a11100010112121101211b10221102022120211210b101101111
1111011111111110001111101010111111112010011022222101101222210201b2001001000111110121111111111110111001110111a11111111100222110201b22121120111111221110b110111101
1100111111101011110011110001111110111020112120220110211212212222b0221112120222201222111101111100111111111111a01100001112200011212a21102112110110212102a111111101
1111110111111100010111011001010011112201212201122021122201102002a2202010220212202102111111111111111111111110a11111111011112212221b00121122122021112022b111111011
1111111011111100011111101001011111012112210101121120120220200222b2222101112021221120111111110111111101010111a11111111111110110111a11111111111111111110a111111011
1001011111011110001101111011111110111002021122120121122112022022b2201122022111120100000110111110011111111110a11111111111011111011a11110111011111011001a101111111
1111111001111111101011111111111001011110111111101111211221201112b2220101212022022101111111110011110111110111a11111111110011010111a11011110101101111111a111101101
1111001111111011111111111101111111111001111111111011221200120021b1111112121000020222111111111011101111111100a01001110111111100011a11110011111110111111a101111111
0101100011010011010011111111111110111001110011111111222121101222b1112111111211222012110110000110011111111110a11111111011110111111a01110101011111111111a001111111
1111111111011100011111111101111111100011111011111101010222110212a1121012211222111211011110101111111111110111a11101110111111111010a11111111111111111101a101111100
1011111101111100101111010010111111111110111111001011122221012111a0122120000222222112011110011111101101110010a11011111011111111111a11111111101111111001a111111111
1111011111111111111111111011111111101111110111111110111121211200a2021010212221121102111111111010110110110101a11111111111111111110a01101001110000101111a111110111
1101111111111011111001111110111110111101001011111011112120212101a2012112202002211222111111110111101011010111a11101111111110011111a01111111111111111101a010110011
1101111011111011110100110011111101111010101111111111111121222100a1001212101211221220010100110110011111111111a11111110111111001110a11011110111111111000a111101110
1111011111101100100111111001111111011101111111110101112111102210b2201101112202122111011111000111100110101011a10111101111110011111a01110011111101111110a111101011
1111101111011110011111111111110011111011001011111111122211222200b2101211202112211222011000110101111011111101a01111111110111111111a10000101111111111110a000010011
0111111101110110111111110110011111100111111111111101211212112121b0001122210220102222101011111010111101111111a10111011111111011001a11101011100001111111a111100110
1111110101010011111111100111111110011110111111110111102220012112b1212122222021121220101001111111111111111010a11111111111111100111a01111111111111111101a111111110
0011001100111111110111011111110111111001111110110110101112111111b1222022000022020021100110100101111111010101a11111111111111111110a10111111111110110111a011111100
1111111101111110111111101111111111100111110011111111001201102012b2121110122000111121011111111101111111101110aaaaaaaaaaaaaaaaaaaaaa10111111101111111111a111101111
0011111111111111110101100111111110111101111101000111111220212111b2200010222221022222122001202001021212210222212011110111111111111111111111111010011111a010111111
1011111111100111101111111011001111101111100111010111222121212112aabababaaaaaabaabbbbab0012122211201222222120022121110101111001110110111111011101111111a111111011
1011111101111111110010111001111101111111101111110111111101011020121021222021112110222a0111121112210112201210202120001111111111110011001111100011111111a111111111
0111111111100111101111111101011011011111111111111110122120120010110122102011022111022b00012022221122001021aaaababaaaaaaaaaaaaaaaa111111110111111101101a100010111
1110011111111011100101011010111101111110011001111110211111111221110111210211212222101b12121112212221210112b112222111111111110100a111101111111111111011a011011111
1111111111111111111011111111011111111110111111011001221021202112221021212222221112002a21212101121201210020b110212111111101111110a110011111010111010111a011110101
1110110111111111111111111111111111100111111111101101002102221201012001211101121122211a02022111112022211222b120111101111101110101a011010110011111001101a111111100
1111111011111100111101111010111111011110101111111111210222212201220022211200211002221b01120110221020110202a102110111111101111101a011111110101111001110a100101110
1111011111111110111111111111111111111111111111011101100111211022220012121120011102111b22221201222021122121b201020011011111111101a011111101111111111101a111000111
1110010111110101111111111110111111101111110011111011002012212210222100222021211012221b12122000122220101010b212122011111110111111a101111011111111111111a011111011
1101111101111111011010111111111111111111111111111101001111110101111111111011111102201a22102222121011211122a100210101010111111110a122211121120102221122b001001021
1011100110011111111110111110111011111110111101111001011110111111101111111011111111010a21012021000011102210b020122001101110111111a101010102122201011211b111021102
1011111111111111010110001111100011111101110110111111110111011011011111111111101111222a00202201221001121220b121222101111010111011a111112022121202001111a211221111
1001010011111111111111110111110101101101110111100101010111101111100111111100001111220b01012201011112120022b111112101100011111111a100021010000201010112a101221020
0111011111111111110111111101111111111110101111101011110101110111111111110111111102121b11201011222001202000b001102111111111111110a220212120111212210111b222221112
1011101111111111111110111111111111010111110111110011011101111011111111110111101010201b21111000120102111120b211211110111110111111a112111020022222001202b112221010
1111101110011110100111111101111101110111111101111011001011011111111101110110110010012b22222021121122110210b120111000101110100111a121121112012210211210a121021110
1111101011110111001101111110111001110101011011111101010011111111011111110111010120010b22220220021121201222b220011001111101000011a002212222120021121101a121122022
1111111011101101110101111111110101111111110111111111110101111110110011111111001112202b01222222101212202220b010211111111101111011a222111220110121220121a202102111
1110111100101101111111111111110111111111101011111111111111111111111111111111011202221b22222222221222221221b221212011111001101101a121212222221201111211b112222112
1121112012120111221101102001102111111101111111101110111111011011111111110111111002021b22222222222201222110a120211010111110110111a120111121111100020111b112220221
aaaabaabbabbaabaaabbaba01122212121110100111000111111101110111111110011111101110101222b12211122202201220211b220212111111101111110a112122121011100111110b210211122
1122212212121201212121a22112222211111001011101111111111111111111100011111111101102221a01200221212220022210b122100111011101111111a120220010101211012120b210101111
0110111211111020110121a12012202011010101011101111011110111110001110111111011111011010b02211022202121221001a202112111111111100111a102100121212012111222a221000122
1222011012210210010021b10221020111111001011011111011111101010000111110111111011012222a22220000022122022222b022221111111111110111abaaaaababbababbaabaaab101212221
0110221011101112211212b21102211221111111111111100101111001110111110111111001100210000b22002122010220200221a22220211111001110101111122211201211122101120122111211
0120211021201120021111a10211111221100011111010110111111101001111111111111111111210011bbbabaaabbbbbbbbbbbbbb22122211111110100011111122220111120120010111111022221
1021112012212112111221b02212202021111110101111101000111111101111101110111010101222202212020222211201210111222221111111101111011100222020212200101110022022222111
1120020110220021212111a20210111210111111111111111101011111111111100111111011110112122110222212020002122012200221101110111111111112022212222210111122121112120112
1112222111100222211221a122220210211011101110111111111111111111010111111111101110221011220110222022220122001122111110111101aaaaaaaabaaaababbbbbbb2220120212112222
1101121211112102211200b122222221210010110111101111010000111110011111111101111111002010221220011102002212200122200111101110a11111011022222201021a0122121222102112
1021122212102110121201b012220222210011111111111111111101101111111111001011111111020222020212022221221022220221222100111011a11101112211211201122b2222220021220011
1211002222011222212220a221220112211111101101111011111111111011011111111111101012221111222221220120202212222222110111111100a10110102010212121112a0012002121011222
1011222101210112102022b010210221111101111011110110111011110111101011111011101110220011210220220212011122112212111111111111a11111110201022102110b2211112012111012
1120010111102110201101b112002210211010111111001111111111001111010111101111011110002111101021010110012010110210111110111101a11111011121101201020a1221220012210222
0021202221120100002122a211112212211111111111111111101101011011111111111111111110121211201220002212201102100202011111011111a11111120121010122122b2221002122211212
1220110220221122222022a212212121011110010111101111110111111110011111101111111111122010210200221122012211211220110011001111a11111112122200012011a1002211212112112
1221210111201012012211a120021220111110101111110110101111011011101010111011011112000112111211021222210121011111211011111110a01111112101121021102b2002112020111111
1102111101201201212220a122012222011011111111111011011011111111111111101111110111211121012101221212221121221112211111001100a11111001221222202122a2012120121220211
0212222212012021022200b221121020011111011111110101111101011111111011011110111112110201112212221210222211011200011111111110a11111122200111221212b2000120012211221
1222020121020021001100b111112122101111111111011101111111111111011101001001110111010202121202012120021000112212011111011111a11111112112221211212a0122200221022112
0202112221112021001110a121020101101011110111110011101111011101111110111011011012100202102112121211200210120210111111110101a11011121102211110112b1221000012012012
1010221210110021212211b122111112010111111111111100111111011101101111011101111011210221122101200120121222201202010111111111a10111011111101111111a1111111111111111
1222011102220120112202b021111222101011111101110111111111111101101111111111011111201120221210110012221121002221011110111101a01011111111111110011a1100001001111111
1220222102222202112111a101221121210111111110011111010111111111111011111101111011222112112210102021111101122112211111111111a11111111010011010101a1111111111111110
1021221011211222122000b021111101210111101111111111101111110010111111101111111112012212122111120101111212210222011110111111a11110100111101101111a1101101101010111
0200111101210211202012a212102210001011110000111111010111111100110100111011111112020212112102122222222022112002011100111110a11011111110101111110a1011111111111111
1121211112211121222121babaaaabbaaaaaaaaaaaaaa11111111110111110111011111111011110212101111202010201012211112122110111111110a01010011110101111101a1111101100110111
10022221122001222021102020122022210101001100a11100101110100111101101011111011111011111111111110011110011101110111110101111a10111111001111111111a1110011000111110
12121120201121120222112221200221111110011111a11111101101110111111010111100111110110110111111111111110111011101110101111111a11010111111111010111a1110111010111111
12112102212220100112101121121212211011111111a01111101101010111001110011111111111110111011111111111001100011101110111101101a01110111111111111101aaaaaaaaaaaaaaaaa
12202220110122120112021100220201011111111111a01111101101011111111100111001011101010111110111000111aaaaaaaaaaaaaaaaaaaaaaaaa1111111111111011111011011111011111001
11111111101011011011101101111110101101110001a11101010101110111111111100111111111111111111111101111a1111110001011111110111101000111111111111011010011100111111111
11110011111111111111011111111111111111111110a10011111100111100101110011011111110111111111000101111a1011111110110010111010110001101111011011110111011001100101111
11101111110111111110111010111111111111111111a11111001111011111111011111101101111011111111100011111a0111011011101110111110110101111111111011111111110000110111111
11110011111101100011011111110111111110100111a11111111111110111111111011011110111111101110101101111a1110110101111101011111111111110101111111110111111110111111101
01100110111010111111011110110011100111101101a11010101111101110011111111000101111111101110110101111a1010110011110001111101111010111111011000100111001110010111110
11111110111011111111111101101101111011100011a11100101111100001101111110110111111111101111011101000a0111111110010111101101100111110001110001111110111101111111111
11101101011111111111100111111011111011111101a01011110110111111111011111110101110110111111110011011a0111111010100111111110111111110111111111111111111100111111111
00111111111111110110011111111111011111110111a01111000111011111111101111111110101111111111111111111a1111110110111101101101111110001110111111111111111111111101001
11011111111111110111111101111110011111101111a10110101110111110111011111111101011110011101101011111a1101111011111111111111111111111111110011111110101100111111111
10111110110111111111111100111101100011111111a11111101101111111111000111111111101111111011110111111a1110111011111111101101111011111110111011101011111110111111011
11111011001111111111011100111011010111110111a11100110000110100010011111111111111110111110101111111a1000111101111111111011000011110111110001110111111101111111111
01111001101111111111101100111110101100111010a10111110110001101110110111011111110111111111111100111a0111101101111111111111111010111101011111100111111000110110111
11101011111011111101100101010111111111011111a11111111110011011010111111111011111111011101101101101a1111111101111111110001011111010100110111111111111111110111011
11101111111111111010110111110011010011111111a11111101011110111101111111111111110101111101111000111a1111110111011111011111111111101111010001110011000110011110111
10111101101011111111111111110010110111100111a11110011111111111011110111111011111111101101101111111a1011111011110101111111111111110111111111111000101001111110010
10111001111100111101111011011101111111001111a11111110101111110111110111011010110110111001011110101a1111001111011111101011101111011011110111111111111011101110110
11111110111111011111111111001011111101100111a01111111011001010100111111110011110110111101110111101a1111011011111100111111111111110111110111110001111101111011011
11111010111101011111101110100111101011111111a11111110111011110111111011101111111101111111111111011a1101011111010111100101111101111111111011111111101010010110111
11101111111111101101111111011111111111111011aaaaaaaaaaaaaaaaaaaaaaaaa11111111011101111011111111011a1111011101111100111011011111100111111011100110111101111011111
10111011011111110110001111101110111111111111101111001111101111101111a11111111101111110111111101111a1011101110111010111010111111111111101111111100101011111111001
11111011111001011110010110111011111111111011111110111000110111111001a01111010110101110111101001111a1000110111111101111111011111011111110101010111110010100111010
156,36
12,38
144,116
14,70
154,96
7,1
137,18
69,101
52,15
48,117
151,63
10,62
157,69
10,107
7,110
156,40
18,24
150,83
